1111111111111
1001000C000C1
1000011000001
1P0011E000011
1111111111111