1111111111111
1001000C000C1
1000011000P01
10001E0000011
1111111111111